0000000000000000000000000
0022200000222000000000000
0211120002111200000000000
0211112000222000002200000
0022112000000000021120000
0000220000000000211112000
0000000222000002111112000
0000002111200002111111200
0000021111200002113111200
0000211311200021133311200
0000211122000021133111200
0000022200000211331112000
0000000000000211111120000
0000000000000021112200000
0000222200000002120000000
0002111120000002122000000
0021111112000021111200000
0002222220000002222000000
0000000000000000000000000