000000000000
002220000000
021112000000
021111200000
002211200000
000022000000
000000022200
000000211120
000002111120
000021131120
000021112200
000002220000